"a" = (/obj/effect/landmark/clear,/turf/template_noop,/area/template_noop)
"b" = (/turf/simulated/wall/wood,/area/template_noop)
"c" = (/obj/machinery/power/port_gen/pacman,/turf/simulated/floor/wood,/area/template_noop)
"d" = (/obj/structure/closet/cabinet,/obj/item/clothing/under/color/black,/obj/item/clothing/shoes/jungleboots,/obj/item/clothing/mask/breath,/turf/simulated/floor/carpet/green,/area/template_noop)
"e" = (/turf/simulated/floor/carpet/green,/area/template_noop)
"f" = (/obj/structure/bed,/obj/item/weapon/bedsheet/purple,/turf/simulated/floor/carpet/green,/area/template_noop)
"g" = (/obj/structure/window/reinforced/full,/turf/simulated/floor/wood,/area/template_noop)
"h" = (/obj/structure/table/woodentable,/obj/item/weapon/board,/turf/simulated/floor/wood,/area/template_noop)
"i" = (/obj/item/device/flashlight/lamp/green,/obj/structure/table/woodentable,/turf/simulated/floor/carpet/green,/area/template_noop)
"j" = (/obj/structure/table/woodentable,/obj/item/clothing/mask/smokable/pipe/cobpipe,/obj/item/weapon/storage/chewables/rollable/generic,/obj/item/weapon/material/ashtray/bronze,/turf/simulated/floor/carpet/green,/area/template_noop)
"k" = (/obj/structure/table/woodentable,/obj/item/weapon/material/kitchen/utensil/fork/plastic,/obj/item/weapon/material/kitchen/utensil/fork/plastic,/obj/item/weapon/material/kitchen/utensil/fork/plastic,/obj/item/weapon/material/knife/table,/obj/effect/floor_decal/spline/fancy/wood/corner{dir = 1},/turf/simulated/floor/tiled/monotile,/area/template_noop)
"l" = (/obj/structure/table/woodentable,/obj/item/weapon/material/knife/table,/obj/item/weapon/material/knife/table,/obj/effect/floor_decal/spline/fancy/wood{icon_state = "spline_fancy"; dir = 1},/turf/simulated/floor/tiled/monotile,/area/template_noop)
"m" = (/obj/structure/closet/crate/freezer,/obj/effect/floor_decal/spline/fancy/wood{icon_state = "spline_fancy"; dir = 1},/turf/simulated/floor/tiled/monotile,/area/template_noop)
"n" = (/obj/machinery/appliance/cooker/oven,/obj/effect/floor_decal/spline/fancy/wood{dir = 4},/obj/effect/floor_decal/spline/fancy/wood/corner{dir = 4},/turf/simulated/floor/tiled/monotile,/area/template_noop)
"o" = (/turf/simulated/floor/wood,/area/template_noop)
"p" = (/obj/structure/bed/chair/wood{tag = "icon-wooden_chair_preview (WEST)"; icon_state = "wooden_chair_preview"; dir = 8},/obj/effect/floor_decal/spline/fancy/wood/corner,/turf/simulated/floor/wood,/area/template_noop)
"q" = (/obj/structure/table/woodentable,/obj/item/weapon/book/manual/detective,/obj/item/weapon/material/ashtray/bronze,/obj/item/weapon/deck/cards,/turf/simulated/floor/wood,/area/template_noop)
"r" = (/obj/effect/floor_decal/spline/fancy/wood{icon_state = "spline_fancy"; dir = 1},/turf/simulated/floor/wood,/area/template_noop)
"s" = (/obj/structure/table/woodentable,/obj/effect/decal/cleanable/blood/drip,/obj/effect/decal/cleanable/blood/drip,/obj/effect/decal/cleanable/blood/drip,/obj/item/weapon/material/knife/kitchen/cleaver,/turf/simulated/floor/tiled/monotile,/area/template_noop)
"t" = (/turf/simulated/floor/tiled/monotile,/area/template_noop)
"u" = (/obj/effect/floor_decal/spline/fancy/wood{dir = 4},/turf/simulated/floor/tiled/monotile,/area/template_noop)
"v" = (/obj/machinery/r_n_d/server/robotics{desc = "A jury-rigged server setup."; name = "low-tech server"},/turf/simulated/floor/tiled/monotile,/area/template_noop)
"w" = (/turf/simulated/floor/wood/usedup,/area/template_noop)
"x" = (/obj/structure/table/woodentable,/obj/item/device/flashlight/lamp,/obj/effect/floor_decal/spline/fancy/wood,/turf/simulated/floor/tiled/monotile,/area/template_noop)
"y" = (/obj/effect/floor_decal/spline/fancy/wood,/turf/simulated/floor/tiled/monotile,/area/template_noop)
"z" = (/obj/effect/floor_decal/spline/fancy/wood{dir = 6},/turf/simulated/floor/tiled/monotile,/area/template_noop)
"A" = (/obj/effect/floor_decal/spline/fancy/wood{dir = 4},/turf/simulated/floor/wood,/area/template_noop)
"B" = (/obj/effect/floor_decal/spline/fancy/wood/corner{dir = 1},/turf/simulated/floor/wood,/area/template_noop)
"C" = (/obj/structure/table/woodentable,/obj/machinery/computer/atmoscontrol/laptop{desc = "A cheap, beat-up old laptop."; name = "old laptop"},/turf/simulated/floor/tiled/monotile,/area/template_noop)
"D" = (/obj/structure/bed/chair/wood{tag = "icon-wooden_chair_preview (WEST)"; icon_state = "wooden_chair_preview"; dir = 8},/obj/effect/floor_decal/spline/fancy/wood{dir = 4},/turf/simulated/floor/tiled/monotile,/area/template_noop)
"E" = (/obj/effect/floor_decal/spline/fancy/wood/corner,/turf/simulated/floor/wood,/area/template_noop)
"F" = (/obj/effect/floor_decal/spline/fancy/wood,/turf/simulated/floor/wood,/area/template_noop)
"G" = (/obj/effect/floor_decal/spline/fancy/wood/corner{dir = 8},/turf/simulated/floor/wood,/area/template_noop)
"H" = (/obj/machinery/door/unpowered/simple/wood,/turf/simulated/floor/wood,/area/template_noop)
"I" = (/obj/structure/table/rack,/obj/item/weapon/storage/box/ammo/shotgunshells,/obj/item/weapon/gun/projectile/shotgun/pump,/turf/simulated/floor/wood,/area/template_noop)
"J" = (/obj/structure/closet,/obj/item/stack/material/steel/ten,/obj/item/stack/material/wood/fifty,/obj/item/stack/tile/carpetgreen/fifty,/obj/item/stack/material/glass/reinforced/ten,/obj/effect/floor_decal/spline/fancy/wood/corner{dir = 8},/turf/simulated/floor/wood,/area/template_noop)
"K" = (/obj/effect/floor_decal/spline/fancy/wood{dir = 5; icon_state = "spline_fancy"},/turf/simulated/floor/wood,/area/template_noop)
"L" = (/obj/machinery/portable_atmospherics/hydroponics/soil,/obj/item/seeds/towermycelium,/obj/effect/landmark/clear,/turf/template_noop,/area/template_noop)
"M" = (/obj/machinery/portable_atmospherics/hydroponics/soil,/obj/item/seeds/potatoseed,/obj/effect/landmark/clear,/turf/template_noop,/area/template_noop)
"N" = (/obj/structure/bed,/obj/item/weapon/bedsheet/orange,/obj/item/weapon/gun/projectile/heavysniper/boltaction,/turf/simulated/floor/carpet/green,/area/template_noop)
"O" = (/obj/machinery/portable_atmospherics/hydroponics/soil,/obj/item/seeds/wheatseed,/obj/effect/landmark/clear,/turf/template_noop,/area/template_noop)
"P" = (/obj/machinery/portable_atmospherics/hydroponics/soil,/obj/item/seeds/random,/obj/effect/landmark/clear,/turf/template_noop,/area/template_noop)
"Q" = (/obj/machinery/portable_atmospherics/powered/scrubber,/turf/simulated/floor/wood,/area/template_noop)
"R" = (/obj/structure/bed/chair/wood{dir = 4; holographic = 1; icon_state = "wooden_chair_preview"},/turf/simulated/floor/wood,/area/template_noop)
"S" = (/obj/machinery/portable_atmospherics/powered/scrubber,/obj/effect/floor_decal/spline/fancy/wood/corner,/turf/simulated/floor/wood,/area/template_noop)
"T" = (/obj/effect/landmark/clear,/mob/living/simple_animal/hostile/russian/ranged/bad_atmos,/turf/template_noop,/area/template_noop)
"U" = (/obj/effect/floor_decal/spline/fancy/wood{icon_state = "spline_fancy"; dir = 1},/mob/living/simple_animal/hostile/russian/bad_atmos,/turf/simulated/floor/wood,/area/template_noop)
"V" = (/obj/machinery/media/jukebox/old,/turf/simulated/floor/wood,/area/template_noop)

(1,1,1) = {"
aabbbbbbaaaaaaaa
aabdeefbbggbbbbb
aabieejbklmnVocb
bbbUKeNbsttuooob
bvuwAeebxyyzRhpb
bCDEorrHEFGwoqAg
bbbbbbbbbgbbooAg
aaaaLaLaMaMbwoBb
aaaaLaMaOaPbQoIb
aaaTaaaaaaabSFJb
aaaaaaaaaaabbHbb
"}
